1,1,1,1,1,1,1,1,1,1,1,1,1,1,1,1,1,1,1,1
1,-1,7,-1,7,-1,-1,-1,-1,-1,-1,-1,-1,-1,-1,-1,-1,-1,-1,1
1,2,2,2,2,2,5,5,5,5,5,-1,-1,-1,-1,-1,-1,-1,-1,1
1,10,10,10,10,10,10,10,10,10,5,-1,-1,-1,-1,-1,-1,-1,-1,1
1,-1,-1,-1,-1,-1,-1,-1,-1,10,10,5,5,5,5,5,5,-1,-1,1
1,-1,-1,-1,-1,-1,-1,-1,-1,-1,10,10,10,10,10,10,10,-1,-1,1
1,-1,-1,-1,-1,-1,-1,-1,-1,-1,-1,-1,-1,-1,-1,-1,-1,-1,-1,1
1,-1,-1,-1,-1,-1,-1,-1,-1,-1,-1,-1,-1,-1,-1,-1,-1,-1,14,1
1,-1,-1,-1,-1,-1,-1,-1,-1,-1,-1,-1,-1,5,5,5,5,5,5,1
1,-1,-1,-1,-1,-1,-1,-1,-1,-1,-1,-1,-1,5,10,10,10,10,10,1
1,-1,-1,-1,-1,-1,-1,7,-1,5,5,5,5,10,10,-1,-1,-1,-1,1
1,-1,-1,-1,-1,-1,5,5,5,10,10,10,10,10,-1,-1,-1,-1,-1,1
1,-1,-1,-1,5,5,10,10,10,-1,-1,-1,-1,-1,-1,-1,-1,-1,-1,1
1,-1,0,-1,5,-1,-1,-1,-1,-1,-1,-1,-1,-1,-1,-1,-1,9,-1,1
1,2,2,2,2,2,2,2,2,2,2,2,2,2,2,2,2,2,2,1
