2,2,2,2,2,2,2,2,2,2,2,2,2,2,2,2,2,2,2,2,2,2,2,2,2
1,-1,-1,-1,-1,1,-1,12,-1,-1,-1,-1,-1,-1,-1,5,-1,-1,-1,-1,-1,-1,-1,-1,1
1,-1,0,-1,-1,1,-1,-1,-1,-1,-1,-1,-1,-1,-1,5,-1,-1,-1,-1,-1,-1,-1,-1,1
1,2,2,-1,-1,1,9,-1,-1,-1,-1,-1,-1,-1,-1,5,-1,-1,-1,-1,-1,-1,-1,-1,1
1,-1,-1,-1,-1,1,2,2,2,2,2,2,2,2,2,2,5,6,5,2,2,2,-1,-1,1
1,-1,-1,-1,-1,-1,-1,-1,-1,-1,-1,-1,-1,-1,-1,1,-1,-1,-1,-1,-1,-1,-1,-1,1
1,-1,-1,-1,-1,-1,-1,-1,-1,-1,-1,-1,-1,-1,-1,1,-1,-1,-1,-1,-1,-1,-1,-1,1
1,-1,-1,-1,-1,2,2,2,-1,-1,-1,-1,-1,-1,-1,1,-1,-1,-1,-1,-1,-1,-1,14,1
1,-1,-1,-1,-1,1,6,6,-1,8,-1,-1,11,11,11,1,-1,-1,-1,-1,-1,-1,2,2,1
1,-1,-1,-1,-1,1,6,6,-1,-1,-1,-1,-1,-1,-1,1,-1,-1,-1,-1,-1,-1,1,7,1
1,-1,4,2,2,1,6,6,-1,-1,-1,-1,-1,-1,-1,1,-1,-1,-1,-1,-1,-1,1,6,1
1,-1,-1,-1,1,1,1,1,-1,-1,-1,-1,-1,-1,8,1,-1,-1,-1,-1,-1,-1,-1,-1,1
1,-1,-1,-1,1,1,-1,-1,-1,-1,-1,-1,-1,-1,7,1,-1,-1,-1,-1,-1,-1,-1,-1,1
1,-1,-1,-1,1,1,-1,-1,-1,8,-1,-1,-1,-1,6,-1,-1,-1,-1,-1,-1,-1,-1,-1,1
1,14,-1,-1,1,1,-1,-1,-1,-1,-1,-1,-1,-1,-1,-1,-1,-1,-1,-1,-1,-1,-1,8,1
1,2,-1,-1,1,1,-1,-1,-1,-1,-1,-1,-1,-1,-1,-1,-1,-1,-1,-1,14,-1,-1,-1,1
1,-1,-1,-1,1,1,-1,-1,-1,-1,-1,-1,-1,-1,-1,-1,-1,-1,-1,-1,2,2,-1,-1,1
1,-1,-1,8,1,-1,12,-1,-1,-1,-1,-1,-1,-1,-1,-1,-1,-1,-1,-1,-1,-1,-1,8,1
1,-1,-1,-1,1,-1,-1,-1,-1,-1,-1,-1,8,-1,-1,-1,-1,-1,8,-1,-1,-1,-1,-1,1
1,-1,-1,7,1,7,-1,-1,-1,-1,-1,-1,-1,-1,-1,-1,-1,-1,-1,-1,-1,-1,-1,-1,1
1,2,2,2,1,1,2,2,2,2,10,10,10,10,10,10,10,10,10,10,2,2,2,2,1
