1,7,1,1,1,1,1,1,1,1,1,1,1,1,1,1,1,1,1,1,1,1,1,1,1,1,1,13,1,1
1,13,-1,13,-1,13,-1,13,-1,13,-1,-1,-1,-1,1,7,-1,-1,-1,-1,-1,-1,-1,13,13,1,6,6,6,1
1,6,6,6,6,6,6,6,6,6,-1,-1,7,-1,1,6,-1,-1,-1,-1,11,11,6,6,6,1,6,6,6,1
1,-1,-1,-1,-1,-1,-1,-1,-1,-1,-1,12,-1,-1,1,-1,-1,-1,-1,11,11,11,11,11,11,1,6,6,6,1
1,-1,18,-1,-1,-1,-1,-1,-1,17,-1,-1,-1,-1,1,-1,11,11,11,11,11,11,11,11,11,1,-1,-1,-1,1
1,-1,-1,-1,-1,-1,-1,-1,-1,-1,-1,-1,-1,-1,1,-1,-1,-1,-1,-1,-1,-1,-1,-1,-1,-1,-1,-1,-1,1
1,-1,-1,-1,-1,-1,15,-1,-1,-1,-1,2,2,2,1,11,11,11,11,11,11,11,-1,-1,-1,-1,-1,-1,-1,1
1,-1,-1,-1,-1,-1,-1,-1,-1,-1,-1,1,1,1,1,5,5,5,1,-1,-1,-1,-1,-1,-1,-1,-1,-1,-1,1
1,-1,-1,-1,-1,-1,-1,-1,-1,-1,-1,6,-1,-1,-1,-1,-1,-1,1,-1,-1,-1,-1,-1,-1,-1,-1,-1,-1,1
1,-1,-1,-1,-1,-1,-1,-1,-1,-1,-1,6,-1,-1,-1,-1,9,-1,1,-1,-1,-1,-1,-1,-1,-1,-1,-1,-1,1
1,-1,16,-1,-1,-1,-1,16,-1,-1,-1,6,-1,0,-1,2,2,2,1,-1,-1,-1,14,-1,-1,-1,14,-1,-1,1
1,-1,-1,-1,-1,-1,-1,-1,-1,-1,-1,1,2,2,2,1,1,1,1,-1,-1,2,2,-1,-1,2,2,-1,-1,1
1,-1,-1,-1,-1,-1,-1,-1,-1,-1,-1,-1,-1,-1,-1,-1,7,-1,-1,-1,-1,-1,-1,-1,-1,-1,-1,-1,-1,1
1,-1,-1,-1,-1,-1,-1,-1,-1,-1,-1,-1,-1,-1,-1,6,6,-1,-1,-1,-1,-1,-1,-1,-1,-1,-1,-1,-1,1
1,-1,11,-1,-1,-1,11,-1,-1,-1,-1,-1,-1,-1,-1,-1,-1,-1,-1,-1,-1,-1,-1,-1,-1,-1,-1,-1,-1,1
1,-1,-1,-1,11,-1,-1,-1,11,-1,-1,-1,-1,-1,4,-1,-1,4,-1,-1,-1,-1,-1,-1,-1,-1,-1,-1,-1,1
1,-1,-1,-1,-1,-1,-1,-1,-1,-1,-1,-1,-1,4,-1,4,4,-1,4,-1,14,-1,-1,-1,-1,-1,-1,-1,-1,1
1,-1,-1,-1,-1,-1,-1,-1,-1,-1,-1,2,4,-1,-1,-1,-1,-1,-1,4,2,-1,-1,-1,-1,-1,-1,-1,-1,1
1,10,10,10,10,10,10,10,10,10,10,1,10,10,10,10,10,10,10,10,1,10,10,10,10,10,10,7,10,1
1,1,1,1,1,1,1,1,1,1,1,1,1,1,1,1,1,1,1,1,1,1,1,1,1,1,1,1,1,1
