1,-1,-1,-1,-1,-1,-1,-1,-1,-1,-1,-1,-1,-1,-1,-1,7,1,1,1
1,-1,-1,-1,-1,-1,-1,-1,-1,-1,-1,-1,-1,-1,-1,-1,13,1,1,1
1,-1,-1,-1,-1,-1,-1,-1,-1,-1,-1,-1,-1,-1,-1,-1,6,1,1,1
1,-1,-1,-1,13,13,13,13,13,-1,-1,-1,-1,-1,-1,-1,-1,1,1,1
1,-1,-1,-1,6,6,6,6,6,-1,-1,-1,-1,-1,8,-1,-1,1,1,1
1,-1,-1,-1,-1,7,7,-1,6,-1,-1,-1,-1,-1,-1,-1,-1,1,1,1
1,-1,-1,-1,-1,-1,-1,-1,6,-1,-1,-1,-1,-1,-1,-1,-1,1,1,1
1,-1,-1,-1,-1,-1,-1,-1,6,-1,-1,-1,-1,-1,-1,-1,10,1,1,1
1,-1,-1,-1,-1,-1,-1,-1,6,-1,-1,-1,-1,-1,-1,-1,11,1,1,1
1,-1,-1,-1,-1,-1,-1,-1,6,-1,-1,-1,-1,-1,-1,-1,10,-1,-1,1
1,-1,-1,-1,-1,-1,-1,-1,6,-1,-1,-1,-1,-1,-1,-1,10,-1,-1,1
1,-1,-1,-1,-1,-1,-1,-1,6,-1,-1,-1,-1,-1,-1,-1,10,-1,-1,1
1,-1,0,-1,-1,-1,-1,-1,6,-1,-1,-1,14,-1,7,-1,10,9,-1,1
1,2,2,2,10,10,10,10,10,2,2,2,2,2,2,2,2,2,2,1
1,1,1,1,1,1,1,1,1,1,1,1,1,1,1,1,1,1,1,1
