1,-1,-1,-1,-1,-1,-1,1,-1,-1,-1,-1,-1,-1,-1,-1,-1,-1,-1,1
1,-1,-1,-1,-1,-1,-1,1,-1,7,-1,-1,-1,-1,-1,-1,-1,-1,-1,1
1,-1,7,-1,-1,-1,-1,1,1,1,1,-1,-1,-1,-1,-1,-1,-1,-1,1
1,6,6,6,-1,-1,-1,-1,1,-1,1,-1,-1,-1,-1,-1,-1,-1,-1,1
1,-1,-1,-1,4,4,-1,-1,1,0,1,11,-1,-1,-1,13,-1,-1,-1,1
1,-1,-1,-1,-1,-1,-1,17,1,-1,1,-1,17,-1,-1,6,-1,-1,-1,1
1,13,13,13,-1,-1,-1,-1,1,-1,1,-1,-1,-1,-1,-1,-1,-1,-1,1
1,6,6,6,-1,-1,-1,-1,1,-1,1,-1,-1,-1,-1,10,-1,-1,-1,1
1,-1,-1,-1,-1,-1,-1,-1,1,-1,1,-1,-1,-1,-1,10,-1,-1,7,1
1,-1,7,-1,-1,-1,-1,-1,1,-1,1,-1,-1,-1,-1,10,4,4,4,1
1,10,10,10,1,-1,-1,-1,1,-1,1,-1,-1,-1,-1,10,1,1,1,1
1,10,10,10,1,-1,-1,-1,-1,-1,12,-1,-1,-1,11,11,1,1,1,1
1,1,1,1,1,11,11,-1,-1,-1,-1,-1,-1,11,-1,-1,1,1,1,1
1,7,-1,-1,5,-1,-1,-1,-1,9,-1,-1,-1,-1,-1,-1,1,1,1,1
1,2,2,2,2,2,2,2,2,2,2,2,2,10,10,10,1,1,1,1
