-1,-1,-1,-1,-1,-1,-1,-1,13,13,13,13,13,-1,-1,-1,-1,-1,-1,-1
-1,-1,-1,-1,-1,-1,-1,-1,13,13,13,13,13,-1,-1,-1,-1,-1,-1,-1
-1,-1,-1,-1,-1,-1,-1,-1,13,13,13,13,13,-1,-1,-1,-1,-1,-1,-1
-1,-1,-1,-1,-1,-1,-1,-1,13,13,13,13,13,-1,-1,-1,-1,-1,-1,-1
-1,-1,-1,-1,-1,-1,-1,-1,13,13,13,13,13,-1,-1,-1,-1,-1,-1,-1
-1,-1,-1,-1,-1,-1,-1,-1,13,13,13,13,13,-1,-1,-1,-1,-1,-1,-1
-1,-1,-1,-1,-1,-1,-1,-1,13,13,13,13,13,-1,-1,-1,-1,-1,-1,-1
-1,-1,-1,-1,-1,-1,-1,-1,13,13,13,13,13,-1,-1,-1,-1,-1,-1,-1
-1,-1,-1,-1,-1,-1,-1,-1,13,13,13,13,13,-1,-1,-1,-1,-1,-1,-1
-1,-1,-1,-1,-1,-1,-1,-1,13,13,13,13,13,-1,-1,-1,-1,-1,-1,-1
-1,-1,-1,-1,-1,-1,-1,-1,13,13,13,13,13,-1,-1,-1,-1,-1,-1,-1
-1,-1,-1,-1,-1,-1,-1,-1,13,13,13,13,13,-1,-1,-1,-1,-1,-1,-1
-1,-1,-1,-1,-1,-1,-1,-1,13,13,13,13,13,-1,-1,-1,-1,-1,-1,-1
10,10,10,10,10,10,10,10,13,13,13,13,13,10,10,10,10,10,10,10
1,1,1,1,1,1,1,1,13,13,13,13,13,1,1,1,1,1,1,1
1,6,6,6,6,6,6,6,6,6,6,6,6,-1,-1,-1,-1,-1,-1,1
1,6,-1,-1,-1,-1,-1,-1,35,-1,-1,-1,-1,-1,-1,-1,-1,-1,-1,1
1,6,7,-1,-1,-1,15,-1,35,35,-1,-1,-1,-1,-1,-1,-1,-1,-1,1
1,6,6,6,-1,-1,-1,-1,35,35,35,35,-1,-1,-1,-1,-1,-1,-1,1
1,2,2,2,-1,-1,-1,-1,35,-1,-1,-1,-1,-1,-1,-1,-1,9,-1,1
1,-1,-1,-1,-1,-1,-1,-1,10,10,10,10,10,2,2,2,2,2,2,1
1,-1,-1,-1,-1,-1,-1,-1,10,10,10,10,10,1,1,1,1,1,1,1
1,-1,-1,-1,-1,-1,17,-1,-1,-1,-1,-1,-1,-1,-1,-1,-1,7,-1,1
1,-1,-1,-1,-1,-1,-1,-1,10,10,10,10,10,2,2,2,2,2,2,1
1,-1,-1,-1,-1,-1,-1,-1,10,10,10,10,10,1,1,1,1,1,1,1
1,-1,-1,-1,-1,-1,-1,-1,10,10,10,10,10,1,1,1,1,1,1,1
1,-1,-1,-1,-1,-1,-1,-1,10,10,10,10,10,1,1,1,1,1,1,1
1,-1,-1,-1,-1,-1,-1,-1,-1,-1,-1,-1,-1,-1,-1,-1,-1,-1,-1,1
1,-1,-1,0,-1,-1,7,-1,-1,-1,-1,-1,-1,-1,-1,-1,-1,7,-1,1
1,2,2,2,2,2,2,2,10,10,10,10,10,2,2,2,2,2,2,1
1,1,1,1,1,1,1,1,1,1,1,1,1,1,1,1,1,1,1,1
